jiggle - покачивание, трясти
unworthy - недостойный, презренный
doorway - дверной проем
inn - гостиница
husky - здоровяк, рослый
impatiently - с нетерпением
glance - взгляд
wrist - запястье, наручный
hangouts - тусовки
inhale - вдыхать, затягиваться
executive - должностное лицо, исполнительный
draw <someone> in - привлекать, вовлекать
conceived - задуманный, понятый, зачатый
conceive - забеременеть, зачать, понимать
sheath - оболочка, футляр, обшивка, узкое платье
misty - туманный, неясный
squandering - расточительство, разбазаривание
shattering - сокрушительный
quite so much - довольно много
emphatically - решительно, настойчиво
sip - глоток, потягивать
fortunate - удачливый, благоприятный
fuss - суета, суматоха, суетиться, ссориться
disentangle - распутывать, расхлебывать, высвобождать
entangle - запутывать, спутать
fetus - плод, эмбрион
inquire - спрашивать, исследовать, наводить справки
concourse - сборище, главный зал вокзала
sigh - вздох, вздыхать, охать
recite - читать
signposting - дорожные знаки, указатели
take over - перенимать, принимать должность
close-up - тщательный осмотр, крупным планом
hand back - передать обратно
masonry - кирпичная кладка
crib - кроватка
shrimp - креветка
stun - шок, ошеломление, оглушать
draw - рисовать, втягивать, тянуть
grill - гриль, решетка, жарить
contaminate - загрязнять
displace - вытеснять
immerse - погружать
weave - ткать, плести
petrochemicals - нефтепродукты
crude - сырой, неочищенный
fungus - грибок
syringe - шприц
dormant - бездействующий
ongoing - постоянный, непрерывный
jettison - выбросить за борт, сбрасывать
canteen - столовая
compliance - соответствие, согласие, податливость
treadmill - бегущая дорожка, однообразный механический труд
weightlessness - невесомость
translucency - полупрозрачность
non-stick - неприлипающий, непригорающий
obedient -  послушник, покорный
hire - наем, прокат, нанимать
firm - фирма, твердо, укреплять
wedge - клин, заклинить
taper - конус, конусность, заострять
skid - занос, скользить
relinquish - отказаться
recall - отзыв, воспоминание, напоминать, отменять
regain - восстановление, вернуть себе
alertness - бдительность
maintain - поддерживать, содержать, обслуживать, сохранять
favor - одолжение, благосклонность, благоприятствовать
gust - порыв ветра
lance - копье
hoist - подъемник, лебедка, поднимать
precipitator - осадитель
tank - бак
raw - грубый, сырье
tap hole - выпускное отверстие
scrap steel - металлолом
forthright - прямолинейный
calamitous - пагубный
imminent - неизбежный
severe - серьезный
upbeat - оптимистичный, приподнятый
agenda - повестка дня
likelihood - вероятность
reclamation - восстановление, мелиорация
assess - оценивать, облагать налогом
devise - разрабатывать, изобретать
encounter - встреча, столкновение
eruption - извержение, высыпание
containment - сдерживание, политика сдерживания
slick - пятно, пленка, гладкий, ловкий
cap - кепка, крышка, колпак
skim - верхний слой, скользить, снимать
ingot - слиток
casting - литье
spill - пролитие, литье, проливать
campaign - кампания, поход
patch - патч, заплата, пластырь, латать
rumble - грохот
throttle - дроссель
perceive - воспринимать, чувствовать
retain - сохранить, удерживать
compound - соединение, состав, компаунд
noun - существительное
bring about - вызывать, быть причиной
carry out - выполнять, проводить
seam - шов
rudder - руль направления
tiller - рукоятка
oar - весло, грести
agitate - волновать, агитировать, перемешивать
calcinate - кальцинировать
dissolve - растворять
siphon off - откачивать
smelt - корюшка, нюхать, выплавлять
suspend - приостановить
make up - составить, компенсировать, гриммировать
brittle - ломкий
consecutive - последовательный
purity - чистота
residual - остаток, остаточный
stressful - стрессовый, напряженный
alumina - глинозем, оксид алюминия
bauxite - боксит, алюминиевая руда
bond - связь, узы, соединение, облигация
crusher - дробилка
crust - кора, корка, покрываться коркой
ladle - ковш, черпак
lime - лайм, известь
precipitation - осадки, осаждение
shortage - нехватка
slay - ботан, убить, шлак
furnace - печь, обжигать в печи
aisle - проход
digester - автоклав, варочный котел, кастрюля-скороварка
appoint - назначать, определять, утверждать
sewer - канализация, сточная труба
punish - наказывать
legislative - законодательный
judicial - судебный
vainly - напрасно, тщетно
obey - подчиняться
exertion - напряжение, усилие
conviction - убеждение, убежденность
outword - внешний мир, внешний вид, внешний, наружу
shudder - дрожь, содрагаться
possess - обладать
possessed - одержимый, ненормальный
obsolescent - устаревший, вышедший из употребления
renowned - известный, знаменитый
hive - улей, людской муравейник, жить вместе
gleam - отблеск, луч, светиться, проблескивать
boast - хвастовство, хвастаться
peril - опасность, подвергать опасности
ordeal - испытание
wipe out - полное уничтожение, уничтожать
counterbalance - противовес, уравновешивать
passion - страсть, увлечение, выражать страсть
purge - чистка, очищать
freckles - веснушки
veering - поворот, отклонение, поворачивающий
entail - майорат, повлечь за собой
shorthand - стенография
deliberately - умышленно, обдуманно
summon - вызывать, призывать
pavement - тротуар, мостовая, дорожное покрытие
crave - жаждать, страстно желать
companionship - общение, товарищеские отношения
stature - рост, стан, фигура
marshal - маршал, судебный исполнитель, выстраивать, торжественно вести
glimpse - взгляд, проблеск, намек, видеть мельком
mischievous - озорной, вредный, непослушный
glimple - проблеск
upheaval - переворот, сдвиг
authentic - подлинный, аутентичный, достоверный